##############################
#  *   ** *  1 * 2 *  I * *  #
# # # #*# # #*#*# # # #*#*#* #
#   * I   ***  *  1   * 2 *  #
# # # # # #*# # #*#*# # # #  #
#f      I   x **  I  *   1   #
# # # # # # # # # #*# #*# #  #
#*  *I     *  *      *    I  #
# # # # #*# # # #*#*# # # #  #
#*    *I  *  1     *         #
# #*# # # # # # #*# # # # #  #
#       *  *   *  I          #
# # # # # # # # # #*# #*# #  #
#*  *      *  I      *       #
##############################
