##############################
#  *   ** *    * D *  I * *  #
# # # #*# # #*#*# # # #*#*#* #
#   * I   ***  *      * D *  #
# # # # # #*# # #*#*# # # #  #
#             *   I  *  B    #
# # # # # # # # # #*# #*# #  #
#*  *I      *       *        #
# # # # #*# # # # #*# # # #  #
#*    *I                     #
# #*# # # # # # #*# # # # #  #
#       *  *   *  I          #
# # # # # # # # # #*# #*# #  #
#*  *      *  I  D   *       #
##############################
