##############################
#B  *I*  *   I  X* *   *     #
# #*# #*# # # # #*#*# # # #  #
#    *     * * *  I  * *   * #
# # # # # # # # # # # # #*#* #
#*      I*     *****     *   #
# # # # # #*# # # # # #I# # *#
#*     *   * B* * *   B *    #
# # # # # # # # # # # #*# #  #
# **      *I        I   *    #
# # # # # # # # # # # # # #* #
#   *I   *    *I    ***     D#
#*# # # # # # # # # # # # #  #
#  ** D *I*   D  *       *   #
##############################