##############################
# **   ** *       *     *    #
# # # #*# # #*#*# # # #*#*#* #
#   * I   ***      O  *   * *#
# # # # # #*# # #*#*# # # # *#
#           X   B I  *      *#
# # # # # # # # # #*# #*# #  #
#*  *I     **       *    B   #
# # # # #*# # # # #*# # # #  #
#     *I    **       O       #
# #*# # # # # # #*# # # # #  #
#    O  *  *      B    I*    #
# # # # # # # # # #*# #*# #  #
#*  *  B    *         *      #
##############################
