##############################
#   *    * X *               #
# #*# # # # # # # #*# # # #* #
#    *  *   *    *        *  #
# # # # #*# # # # # # # # #  #
#     *       *     *        #
# # # # # # # # # # # # # #  #
# *   *   O     * M      *   #
#*# # # # # # # # # # # # #  #
#  M  *   *   *   *    *     #
# # # # # # # # # # # # # #  #
#     *   M   *     *   O    #
# # # # #*#*#*#*# # # # # #  #
# *     * O                  #
##############################