##############################
#O  * *  *      ** *   *     #
# #*# #*# # # # #*#*# # # #  #
# I  *   M * * *  I  * *   * #
# # # # # # # # # # # # #I#* #
#*      I*     * * * O   *   #
# # # # # #*# # # # # #I# # *#
#*         *      M     *    #
# # #M# # # # # # # # #*# #  #
# *       *I        I   *    #
# # # # # # # # # # # #I# #* #
#   *    *    *I    ***      #
#*# # # # #*#*# # # # # #X#  #
#  **   *I*   O  *       *   #
##############################