##############################
#   * *  *      ** *   *     #
# #*# #*# # # # #*#*# # # #  #
# I  *   D * * *  I  * *   * #
# # # # # # # # # # # # #I#* #
#*      I*     * * * V   *   #
# # # # # #*# # # # # #I# # *#
#*         *      D     *    #
# # #D# # # # # # # # #*# #  #
# *       *I        I   *    #
# # # # # # # # # # # #I# #* #
#   *    *    *I    ***      #
#*# # # # #*#*# # # # # #X#  #
#  **   *I*   V  *       *   #
##############################