##############################
#   * V  *   *      X        #
# #*# # # # # # # #*# # # #* #
#    *  *   *    *        *  #
# # # # #*# # # # # # # # #  #
#     *     K *     *   V    #
# # # # # # # # # # # # # #  #
# *   *   K     *        *   #
#*# # # # # # # # # # # # #  #
#     *   *   *   *    *     #
# # # # # # # # # # # # # #  #
#     * V     *     *        #
# # # # #*#*#*#*# # # # # #  #
# *     * K                  #
##############################