##############################
#  **I *             *   I   #
# # # # # # # # # #*# # # #  #
# I      *         *         #
# # # # # # #I# # #*# #V# #  #
#      *   *    *  I*K     * #
# # # # # # # # # # # # # #  #
#I           *      **   **  #
# # # # # # # # # # # # # #  #
#I *  *   *   *   K    *X    #
# # # # #I # # # # # # # # # #
#* I   *    *    *I*  *  *  V#
# #*# # # #*# # #*# # # # #  #
# K  *         V   I   *     #
##############################

