##############################
#  *   ** *  1 * 2 *  I * *  #
# # # #*# # #*#*# # # #*#*#* #
#   * I   ***  *  1   * 2 *  #
# # # # # #*# # #*#*# # # #  #
#f          x *   I  *   1   #
# # # # # # # # # #*# #*# #  #
#*  *I      *       *    I   #
# # # # #*# # # # #*# # # #  #
#*    *I     1       O       #
# #*# # # # # # #*# # # # #  #
#       *  *   *  I          #
# # # # # # # # # #*# #*# #  #
#*  *      *  I  O   *       #
##############################
